levelsJSON = [
    {
        "id": 1,
        "player_initial_position": {
            "x": 32,
            "y": 160
        },
        "has_enemies": false,
        "enemy_initial_position": {
            "x":null,
            "y":null
        },
        "graphical_map":[
            [1,1,1,1,1,1,1,1,1,1,1,1],
            [1,1,1,1,1,1,1,1,1,1,1,1],
            [1,1,1,1,1,1,1,1,1,1,1,1],
            [1,1,1,1,1,1,1,1,1,1,1,1],
            [1,1,1,1,1,1,1,1,1,1,1,1],
            [1,1,1,1,1,1,1,1,1,1,1,1],
            [2,2,2,2,2,2,2,1,1,2,2,2],
            [2,2,2,2,2,2,2,1,1,2,2,2],
            [2,2,2,2,2,2,2,1,1,2,2,2]
        ],
        "collision_map": [
            [0,0,0,0,0,0,0,0,0,0,0,0],
            [0,0,0,0,0,0,0,0,0,0,0,0],
            [0,0,0,0,0,0,0,0,0,0,0,0],
            [0,0,0,0,0,0,0,0,0,0,0,0],
            [0,0,0,0,0,0,0,0,0,0,0,0],
            [0,0,0,0,0,0,0,0,0,0,0,0],
            [1,1,1,1,1,1,1,1,1,1,1,1],
            [1,1,1,1,1,1,1,1,1,1,1,1],
            [1,1,1,1,1,1,1,1,1,1,1,1]
        ],
    },
    {
        "id": 2,
        "player_initial_position": {
            "x": 32,
            "y": 160
        },
        "has_enemies": false,
        "enemy_initial_position": {
            "x":80,
            "y":160
        },
        "graphical_map":[
            [1,1,1,1,1,1,1,1,1,1,1,1],
            [1,1,1,1,1,1,1,1,1,1,1,1],
            [1,1,1,1,1,1,1,1,1,1,1,1],
            [1,1,1,1,1,1,1,1,1,1,1,1],
            [1,1,1,1,1,1,1,1,1,1,1,1],
            [1,1,1,1,1,1,1,1,1,1,1,1],
            [2,2,2,2,2,2,2,1,1,2,2,2],
            [2,2,2,2,2,2,2,1,1,2,2,2],
            [2,2,2,2,2,2,2,1,1,2,2,2]
        ],
        "collision_map": [
            [0,0,0,0,0,0,0,0,0,0,0,0],
            [0,0,0,0,0,0,0,0,0,0,0,0],
            [0,0,0,0,0,0,0,0,0,0,0,0],
            [0,0,0,0,0,0,0,0,0,0,0,0],
            [0,0,0,0,0,0,0,0,0,0,0,0],
            [0,0,0,0,0,0,0,0,0,0,0,0],
            [1,1,1,1,1,1,1,1,1,1,1,1],
            [1,1,1,1,1,1,1,1,1,1,1,1],
            [1,1,1,1,1,1,1,1,1,1,1,1]
        ],
    },
]